{
    "file_type": "level_json",
    "level_name": "12345",
    "width": 35,
    "height": 27,
    "content": [
        "11111111111111111111111111111111111",
        "11111111111111111111111111111111111",
        "11111111111111111111111111111111111",
        "11111111111111111111111111111111111",
        "11111111111111111111111111111111111",
        "11111111111111111111111111111111111",
        "11111111111111111111111111111111111",
        "11111111111111111111111111111111111",
        "11111111111111111111111111111111111",
        "11111111111111111111111111111111111",
        "11111111111111111111111111111111111",
        "11111111111111111111111111111111111",
        "11111111111111111111111111111111111",
        "1111111111111111@111111111111111111",
        "11111111111111111111111111111111111",
        "11111111111111111111111111111111111",
        "11111111111111111111111111111111111",
        "11111111111111111111111111111111111",
        "11111111111111111111111111111111111",
        "11111111111111111111111111111111111",
        "11111111111111111111111111111111111",
        "11111111111111111111111111111111111",
        "11111111111111111111111111111111111",
        "11111111111111111111111111111111111",
        "11111111111111111111111111111111111",
        "11111111111111111111111111111111111",
        "11111111111111111111111111111111111"
    ]
}